L: 1
X: -383
Y: 49
W: 7
H: 7
0;0;0;0;0
1;0;0;0;0
2;0;0;0;0
3;0;0;0;0
4;0;0;0;0
5;0;0;0;0
6;0;0;0;0
0;1;0;0;0
1;1;0;0;0
2;1;0;0;0
3;1;0;0;0
4;1;0;0;0
5;1;0;0;0
6;1;0;0;0
0;2;0;0;0
1;2;0;0;0
2;2;0;0;0
3;2;0;0;0
4;2;0;0;0
5;2;0;0;0
6;2;0;0;0
0;3;0;0;0
1;3;0;0;0
2;3;0;0;0
3;3;43;0;0
4;3;43;0;0
5;3;43;0;0
6;3;0;0;0
0;4;0;0;0
1;4;0;0;0
2;4;0;0;0
3;4;43;0;0
4;4;43;0;0
5;4;43;0;0
6;4;0;0;0
0;5;0;0;0
1;5;0;0;0
2;5;0;0;0
3;5;43;0;0
4;5;43;0;0
5;5;43;0;0
6;5;0;0;0
0;6;0;0;0
1;6;0;0;0
2;6;0;0;0
3;6;0;0;0
4;6;0;0;0
5;6;0;0;0
6;6;0;0;0
