L: -3
X: -33
Y: -95
W: 13
H: 10
0;0;0;0;0
1;0;0;0;0
2;0;0;0;0
3;0;0;0;0
4;0;0;0;0
5;0;42;0;0
6;0;2;0;0
7;0;2;0;0
8;0;2;0;0
9;0;2;0;0
10;0;2;0;0
11;0;2;0;0
12;0;42;0;0
0;1;0;0;0
1;1;0;0;0
2;1;0;0;0
3;1;0;0;0
4;1;0;0;0
5;1;42;0;0
6;1;2;0;0
7;1;2;0;0
8;1;2;0;0
9;1;2;0;0
10;1;2;0;0
11;1;2;0;0
12;1;42;0;0
0;2;0;0;0
1;2;0;0;0
2;2;0;0;0
3;2;0;0;0
4;2;0;0;0
5;2;42;0;0
6;2;2;0;0
7;2;2;0;0
8;2;2;0;0
9;2;2;0;0
10;2;2;0;0
11;2;2;0;0
12;2;42;0;0
0;3;0;0;0
1;3;0;0;0
2;3;0;0;0
3;3;0;0;0
4;3;0;0;0
5;3;42;0;0
6;3;2;0;0
7;3;2;0;0
8;3;2;0;0
9;3;2;0;0
10;3;2;0;0
11;3;2;0;0
12;3;42;0;0
0;4;0;0;0
1;4;0;0;0
2;4;0;0;0
3;4;0;0;0
4;4;0;0;0
5;4;42;0;0
6;4;2;0;0
7;4;2;0;0
8;4;2;0;0
9;4;2;0;0
10;4;2;0;0
11;4;2;0;0
12;4;42;0;0
0;5;0;0;0
1;5;0;0;0
2;5;0;0;0
3;5;0;0;0
4;5;0;0;0
5;5;42;0;0
6;5;2;0;0
7;5;2;0;0
8;5;2;0;0
9;5;2;0;0
10;5;2;0;0
11;5;2;0;0
12;5;42;0;0
0;6;0;0;0
1;6;0;0;0
2;6;0;0;0
3;6;0;0;0
4;6;0;0;0
5;6;42;0;0
6;6;2;0;0
7;6;2;0;0
8;6;2;0;0
9;6;2;0;0
10;6;2;0;0
11;6;2;0;0
12;6;42;0;0
0;7;0;0;0
1;7;0;0;0
2;7;0;0;0
3;7;0;0;0
4;7;0;0;0
5;7;42;0;0
6;7;42;0;0
7;7;42;0;0
8;7;42;0;0
9;7;42;0;0
10;7;42;0;0
11;7;42;0;0
12;7;42;0;0
0;8;0;0;0
1;8;0;0;0
2;8;0;0;0
3;8;0;0;0
4;8;0;0;0
5;8;0;0;0
6;8;0;0;0
7;8;0;0;0
8;8;0;0;0
9;8;0;0;0
10;8;0;0;0
11;8;0;0;0
12;8;0;0;0
0;9;0;0;0
1;9;0;0;0
2;9;0;0;0
3;9;0;0;0
4;9;0;0;0
5;9;0;0;0
6;9;0;0;0
7;9;0;0;0
8;9;0;0;0
9;9;0;0;0
10;9;0;0;0
11;9;0;0;0
12;9;0;0;0
