L: 1
X: -106
Y: -147
W: 10
H: 10
0;0;7;0;0
1;0;7;0;0
2;0;7;0;0
3;0;7;0;0
4;0;7;0;0
5;0;7;0;0
6;0;7;0;0
7;0;7;0;0
8;0;7;0;0
9;0;7;0;0
0;1;7;0;0
1;1;7;0;0
2;1;7;0;0
3;1;7;0;0
4;1;7;0;0
5;1;7;0;0
6;1;7;0;0
7;1;7;0;0
8;1;7;0;0
9;1;7;0;0
0;2;7;0;0
1;2;7;0;0
2;2;7;0;0
3;2;7;0;0
4;2;7;0;0
5;2;7;0;0
6;2;7;0;0
7;2;7;0;0
8;2;7;0;0
9;2;7;0;0
0;3;7;0;0
1;3;7;0;0
2;3;7;0;0
3;3;7;0;0
4;3;7;0;0
5;3;7;0;0
6;3;7;0;0
7;3;7;0;0
8;3;7;0;0
9;3;7;0;0
0;4;7;0;0
1;4;7;0;0
2;4;7;0;0
3;4;7;0;0
4;4;7;0;0
5;4;7;0;0
6;4;7;0;0
7;4;7;0;0
8;4;7;0;0
9;4;7;0;0
0;5;7;0;0
1;5;7;0;0
2;5;7;0;0
3;5;7;0;0
4;5;7;0;0
5;5;7;0;0
6;5;7;0;0
7;5;7;0;0
8;5;7;0;0
9;5;7;0;0
0;6;7;0;0
1;6;7;0;0
2;6;7;0;0
3;6;7;0;0
4;6;7;0;0
5;6;7;0;0
6;6;7;0;0
7;6;7;0;0
8;6;7;0;0
9;6;7;0;0
0;7;7;0;0
1;7;7;0;0
2;7;7;0;0
3;7;7;0;0
4;7;7;0;0
5;7;7;0;0
6;7;7;0;0
7;7;7;0;0
8;7;7;0;0
9;7;7;0;0
0;8;0;0;0
1;8;0;0;0
2;8;0;0;0
3;8;0;0;0
4;8;0;0;0
5;8;0;0;0
6;8;0;0;0
7;8;0;0;0
8;8;0;0;0
9;8;0;0;0
0;9;0;0;0
1;9;0;0;0
2;9;0;0;0
3;9;0;0;0
4;9;0;0;0
5;9;0;0;0
6;9;0;0;0
7;9;0;0;0
8;9;0;0;0
9;9;0;0;0
