L: 2
X: 398
Y: 251
W: 10
H: 10
0;0;0;0;0
1;0;0;0;0
2;0;0;0;0
3;0;0;0;0
4;0;0;0;0
5;0;0;0;0
6;0;0;0;0
7;0;0;0;0
8;0;0;0;0
9;0;0;0;0
0;1;0;0;0
1;1;0;0;0
2;1;43;0;0
3;1;9;0;0
4;1;9;0;0
5;1;9;0;0
6;1;9;0;0
7;1;9;0;0
8;1;0;0;0
9;1;0;0;0
0;2;0;0;0
1;2;43;0;0
2;2;9;0;0
3;2;9;0;0
4;2;9;0;0
5;2;9;0;0
6;2;9;0;0
7;2;9;0;0
8;2;9;0;0
9;2;0;0;0
0;3;0;0;0
1;3;43;0;0
2;3;9;0;0
3;3;9;0;0
4;3;9;0;0
5;3;9;0;0
6;3;9;0;0
7;3;9;0;0
8;3;9;0;0
9;3;0;0;0
0;4;0;0;0
1;4;43;0;0
2;4;9;0;0
3;4;9;0;0
4;4;9;0;0
5;4;9;0;0
6;4;9;0;0
7;4;9;0;0
8;4;9;0;0
9;4;0;0;0
0;5;0;0;0
1;5;43;0;0
2;5;9;0;0
3;5;9;0;0
4;5;9;0;0
5;5;9;0;0
6;5;9;0;0
7;5;9;0;0
8;5;9;0;0
9;5;0;0;0
0;6;0;0;0
1;6;43;0;0
2;6;9;0;0
3;6;9;0;0
4;6;9;0;0
5;6;9;0;0
6;6;9;0;0
7;6;9;0;0
8;6;9;0;0
9;6;0;0;0
0;7;0;0;0
1;7;43;0;0
2;7;9;0;0
3;7;9;0;0
4;7;9;0;0
5;7;9;0;0
6;7;9;0;0
7;7;9;0;0
8;7;9;0;0
9;7;0;0;0
0;8;0;0;0
1;8;0;0;0
2;8;43;0;0
3;8;43;0;0
4;8;43;0;0
5;8;43;0;0
6;8;43;0;0
7;8;43;0;0
8;8;0;0;0
9;8;0;0;0
0;9;0;0;0
1;9;0;0;0
2;9;0;0;0
3;9;0;0;0
4;9;0;0;0
5;9;0;0;0
6;9;0;0;0
7;9;0;0;0
8;9;0;0;0
9;9;0;0;0
